******************
*  S.......G     *
* ****** ******* *
* *      *       *
* *** ******* ****
*  *  *    *     *
*  ****    ****  *
*  *             *
* *********** ****
*  *       *     *
* *****    ****  *
* *   *          *
* *** *** *** ****
*  *       *     *
*  ****    ****  *
*     *          *
* *** ******* ****
*  *       *     *
*  ****   *****  *
*                *
******************
# of calling getNeighbors = 19
