******************
*..S       G.....*
*.****** *******.*
*.*      *   ....*
*.*** *******.****
*..*  *    * ... *
* .****    ****. *
*..*         ... *
*.***********.****
*. *       * ... *
*.*****    ****. *
*.*   *  ....... *
*.*** ***.*** ****
*..*   ... *     *
* .****.   ****  *
*..   *.......   *
*.*** *******.****
*..*   ... * ... *
* .****. .*****. *
* ...... ....... *
******************
# of calling getNeighbors = 142
